111111111101
1c1000001111
100000100001
101111111111
100111100001
110111111001
110000000m11
111110111101
111111111111
